##############
# O  X  P    #
#   X   O    #
#            #
#            #
#O    X      #
##############
